12,12,1,10,7,7,
2,10,1,3,1,
1,1,1,1,1,1,1,1,1,1,1,1,
1,0,0,0,0,0,0,0,0,0,0,1,
1,0,0,0,0,0,1,1,0,0,0,1,
1,0,0,0,0,0,0,1,0,0,0,1,
1,0,0,0,0,0,2,0,1,0,0,1,
1,0,1,1,1,1,1,0,1,1,0,1,
1,0,0,0,0,1,1,1,1,0,0,1,
1,0,0,2,0,0,0,0,1,0,1,1,
1,1,1,1,1,1,1,1,1,0,0,1,
1,0,0,0,0,0,0,0,0,1,0,1,
1,0,0,0,0,0,0,0,0,0,0,1,
1,1,1,1,1,1,1,1,1,1,1,1