10,10,1,1,7,8,
3,1,3,3,3,3,4,      
1,1,1,1,1,1,1,1,1,1,
1,0,0,0,0,0,0,0,0,1,
1,1,1,1,1,1,1,0,0,1,
1,0,1,0,0,0,1,0,0,1,
1,0,1,0,0,0,1,0,0,1,
1,0,1,1,1,1,1,0,0,1,
1,1,1,1,1,1,1,0,0,1,
1,2,2,2,2,2,1,0,0,1,
1,1,1,1,1,1,1,0,2,1,
1,1,1,1,1,1,1,1,1,1