13,13,7,1,1,9,
4,6,3,6,7,4,7,2,7,      
1,1,1,1,1,1,1,1,1,1,1,1,1,
1,0,0,0,0,0,0,0,0,2,2,1,1,
1,1,1,1,0,1,1,1,1,1,1,1,1,
1,0,0,0,0,0,0,0,0,0,0,0,1,
1,0,0,0,0,0,0,0,0,0,0,1,1,
1,0,0,0,2,0,0,0,2,0,0,0,1,
1,1,1,1,1,1,1,1,1,0,0,1,1,
1,0,0,0,0,0,0,0,1,0,1,1,1,
1,0,0,0,0,0,0,0,1,0,0,1,1,
1,0,0,0,0,0,0,0,0,1,0,1,1,
1,0,1,0,1,0,1,0,0,0,0,1,1,
1,2,2,2,2,2,2,1,1,1,1,1,1,
1,1,1,1,1,1,1,1,1,1,1,1,1