{
	"level1": {
		"lx": "12",
		"ly": "12",
		"playerX": "1",
		"playerY": "10",
		"gateX": "7",
		"gateY": "7",
		"enemies":[
                10,1,
                3,1
		],
		"map": [
			          1,1,1,1,1,1,1,1,1,1,1,1,
            		1,0,0,0,0,0,0,0,0,0,0,1,
            		1,0,0,0,0,0,1,1,0,0,0,1,
            		1,0,0,0,0,0,0,1,0,0,0,1,
            		1,0,0,0,0,0,2,0,1,0,0,1,
            		1,0,1,1,1,1,1,0,1,1,0,1,
            		1,0,0,0,0,1,1,1,1,0,0,1,
            		1,0,0,2,0,0,0,0,1,0,1,1,
            		1,1,1,1,1,1,1,1,1,0,0,1,
            		1,0,0,0,0,0,0,0,0,1,0,1,
            		1,0,0,0,0,0,0,0,0,0,0,1,
            		1,1,1,1,1,1,1,1,1,1,1,1
		]
	},
	"level2": {
		"lx": "12",
		"ly": "12",
		"playerX": "1",
		"playerY": "10",
		"gateX": "7",
		"gateY": "7",
		"enemies":[
            10,1
		],
		"map": [
			1,1,1,1,1,1,1,1,1,1,1,1,
            		1,0,0,0,0,0,0,0,0,0,0,1,
            		1,0,0,0,0,0,1,1,0,0,0,1,
            		1,0,0,0,0,0,0,1,0,0,0,1,
            		1,0,0,0,0,0,0,0,1,0,0,1,
            		1,0,1,1,1,1,1,2,1,1,0,1,
            		1,0,0,0,0,1,1,1,1,0,0,1,
            		1,0,0,0,0,0,0,0,1,0,1,1,
            		1,1,1,1,1,1,1,1,1,0,0,1,
            		1,0,0,0,0,0,0,0,0,1,0,1,
            		1,0,0,0,0,0,0,0,0,0,0,1,
            		1,1,1,1,1,1,1,1,1,1,1,1
		]
	}
}